/// Simple welcome pattern (using default tiles)
. . . . . . . . . .
. W E L C O M E . .
. T O . R - T Y P E
. . . . . . . . . .
. . . . . . . . . .
. . . . . . . . . .
