/// Demo map with mixed terrain
. . . . . . . . . . . .
. . ~ ~ ~ . . . . . . .
. # # # . . * * . . . .
. # @ # . . * * . . . .
. # # # . . . . . . . .
. . . . . . . . . . . .
. . . . . . . . . . . .